BASEWIDTH,TS,HC
1150,0,0
950,0,0
1150,0,0
950,0,0
1150,0,0
1050,0,0
1050,0,0
1150,0,0
1150,0,0
1050,0,0
1350,0,0
1150,0,0
1150,0,0
950,0,0
1150,0,0


