,OPTION1,OPTION2,OPTION3,OPTION4
0,0,0,0,1
1,1,0,0,0
2,0,0,1,0
3,0,0,0,1
4,0,1,0,0
5,1,0,0,0
6,0,0,1,0
7,0,1,0,0
8,0,1,0,0
