,OPTION1,OPTION2,OPTION3,OPTION4
0,0,0,1,0
1,0,0,1,0
2,1,0,0,0
3,0,0,1,0
4,0,1,0,0
5,0,0,1,0
6,0,0,1,0
7,1,0,0,0
8,0,0,1,0
9,1,0,0,0
10,1,0,0,0
11,0,0,1,0
12,0,0,1,0
13,0,0,1,0
14,0,1,0,0
15,0,0,0,1
16,0,1,0,0
17,0,1,0,0
18,0,1,0,0
19,0,0,0,1
20,1,0,0,0
21,0,0,1,0
22,0,0,1,0
23,1,0,0,0
24,0,1,0,0
25,0,1,0,0
26,0,0,1,0
27,0,1,0,0
28,1,0,0,0
29,0,0,1,0
30,0,1,0,0
31,0,0,0,1
32,1,0,0,0
33,0,0,1,0
