,OPTION1,OPTION2,OPTION3,OPTION4
0,0,0,0,1
1,1,0,0,0
2,0,0,0,1
3,0,0,0,1
4,0,0,1,0
5,0,1,0,0
6,0,1,0,0
7,0,0,1,0
8,1,0,0,0
9,0,1,0,0
10,0,0,0,1
11,0,1,0,0
12,0,1,0,0
13,0,0,1,0
14,0,1,0,0
15,0,0,1,0
16,0,1,0,0
17,0,1,0,0
18,1,0,0,0
19,1,0,0,0
20,0,0,1,0
21,0,0,1,0
22,0,0,0,1
23,1,0,0,0
24,0,1,0,0
25,0,0,1,0
26,1,0,0,0
27,0,0,1,0
28,0,0,0,1
29,0,0,1,0
30,0,0,0,1
31,0,0,0,1
32,0,0,1,0
33,0,0,1,0
34,0,0,1,0
35,0,1,0,0
36,0,0,1,0
37,0,0,1,0
38,0,1,0,0
39,0,0,0,1
40,0,0,1,0
41,0,0,1,0
42,1,0,0,0
43,1,0,0,0
44,0,0,1,0
45,1,0,0,0
46,1,0,0,0
47,0,0,1,0
48,0,0,0,1
49,0,0,1,0
50,1,0,0,0
51,0,1,0,0
52,0,1,0,0
53,1,0,0,0
54,0,0,1,0
55,0,0,0,1
56,1,0,0,0
57,0,1,0,0
58,1,0,0,0
59,0,1,0,0
60,1,0,0,0
61,0,1,0,0
62,0,1,0,0
63,0,1,0,0
64,0,1,0,0
65,0,1,0,0
66,1,0,0,0
67,1,0,0,0
68,1,0,0,0
69,1,0,0,0
70,0,0,1,0
71,1,0,0,0
72,0,1,0,0
73,0,0,1,0
74,0,1,0,0
